name	raga	seq
Abhogi Kanada	abhogi kanada	srGmd's'sdmGrGmrsr.d.dsrmdssr.dsrGmGmrsGmrsGmrsmGrssr.dsrGmGmd's'sdmdmGrGmrsr.dsrGmrs
Adana	adana	mpDN's'sDN's'sDNpmpGmrssrmpDN's'sDNpmpGmrsGmrs'sNpmGmrssrmpDNpmp'sDNpmpGmrs
Aheer Bhairav	ahir bhairav	gmpdNdpdp'sNdNdpmgmgmpmRRs.N.d.NRRssRgmpdN's'sNdpmgRs'sNdpmgmRss.N.d.NRRsRgmgmpdpmgmRRsgmpdNNdN's's'R'sN'sNdpdpmggmpmRRs.N.d.NRRsgmpgMRRs
Alhaiya Bilawal	alhaiya bilawal	sgp'spggrgpdNdpmgrgpdn'ssrgpdn's'sndpdNdpmgrs'sndpdNdpsrggmrgppmgrgrsgmrgpdgmggpdmggpdn's's'r's'sndpdn's'sndpdNdpdgmgrsN'sndpdNdp'sndpmgrs
Bageshree	bageshri	smd'sdmG.NsmsGmGrs.N.dmdNdmGrssrGmdN's'sNdmpdmGrs.Nssrs.N.Ns.N.d.m.d.N.ds.d.NsmmGGrs.N.NsmmGmdNdmmpdmmGrsGmd'sdNdmd's'r'sNdmmpdmmGrsGmdNdN'sN'sNN'r's'r's's'r'sN'sdNd'smddNdmmpdmmGrs.Ns.NsmGrssGmGrsrGmGrssrGmmGrs.N.NssmmpdmmGrsdNsmmmGGmdGmNNdmdNdmpdm
Bahar	bahar	smpmGmNpmmNdn'sNpmpmGmrssrsmpmGmdn's'sNpmGmrs.nsGmrspmGm
Bairagi	bairagi	sRmpmpNpmRRpmRs.NsRssRmpN's'sNpmRs.NsRmpNmNpNpmpmR.NsRmpNpmpNN'sNpN's'R's'R'sN'R'sNpmpmRs.NsRs
Bairagi Todi	bairagi todi	sRp.NsRGGR.N.p.NRssRGpN's'sNpGRssRGGRsRGpRGRssRGpNpGRGpN'sN's'R's'sNpNpGRGRs.Ns.p.NsRs
Basant	basant	MD'R'sn's'RnDpgMDnMgMDgMgMgMgRssgMDn's'snDpMgMnDMgRssmmgs.nRssgMpMpMgMgMgRsMDnDpgMDnMgpMgMgMgRsMD'R's'RnDpMpMgMggMnMgpMgMgRssmmgmD'R'sn'R's'RnDppMgMg
Basant Mukhari	basant mukhari	sRggmpmpDNDpmpmgmgRRs.N.D.NsRRgmgRsgmRssRgmpDN's'sNDpmgRs.NssRgmpDN'sRRsRgggmmgmppmpDNNDpmgRgmpmND'R'sDNDppmgmRgmpmgmRRs.N.D.NsRgmgpmgRs
Bhairav	bhairav	smpD'sDpRRRsDDpgmDDpgmRRs.nssRgmpDn's'snDpmgRsRRsDDpmpgmpgpmgmRRs.nsRsgmnDDn'sn's'R'R'sDDpmpgmpgmppmgmgmpgmRs.D.nsRRgmDmppmpDpDnDn's'R'R'g'm'R'snDpDDpmpmgmpmmRRssgmDpgmDn's'snDppmgmRRsgmRs
Bhairavi	bhairavi	smp'spmGsRsGmpDmDN's'R'sDpGmRssRGmpDN's'sNDpmGRsRGRGsRsGmppDppDNDmDpGmpmGmRRs.DssGmppDpmMmGRssGRmGsGpmGsRs.NR.N.D.N.D.p.p.D.N.Ds
Bhatiyar	bhatiyar	smpdmssmppgRssdndnpdmpgpgRsMd'ssRssmmdpsddnpmpgMd's's'RndpdnpmpgRssdnpdmpgndnpdmsmmpmdpmpgpgRssddnpdmdpgpgRsMd's'sn'RndpdnpdmdpgRss.n.ds.nRgmdpgpgRs
Bheem	bheem	.NsgmpN's'sNdpmgpmgmrs.Ns.p.Nssgp'spg.Nsgmp'sNp'sN's'spdpdmpgmr.Ns'sgmp'sN's'spdpgmrsmgrsgmpN'sNdpgmrs.NsgmpNp'sN's'spdpdmpgmrsr.Ns.p.Nsgmrs
Bheempalasi	bhimpalasi	smp'spm.NsGmpNdp'sNdpmGrs.NsGmpN's'sNdpmGrs.Ns.p.NsGmpN'sN'sN'ss.N.Ns.NsGrsrs.N.N.Ns.p.NsGGmGrssGmmGppmdpmGmmGpmpmGmGmpGmGGrs.NsmpmGGrssGmpmGppmdpNdppmdpmpmGmpN'sNNNN'spp'sN'r's's'r'sNN'sNdppdpmGpmGmGrs
Bhoopal Todi	bhoopal todi	sGpDDpGss.DsRGDpGRGRssRGpD's'sDpGRs.DRss.Ds.DRRssRGRsRRGRGpRRGGpDpD'sDppRGRsGRRGRs
Bhoopali	bhoopali	grgpgdp'sdpgpgrggrssrgpd's'sdpgrsr.dsss.dsrgrgsr.dssrgppgrgrpggsrr.dsgrgpgpdppdpgprgrs.dssrgrgpd'spdp's's's'r'sd'sd's'r'g'r'sd'sdpgrgprgrsr.ds
Bihag	bihag	sgpn'snpg.nsggmgpMpgmgpMgmgrssgmpn's'sndpMpgmgrs'sndpMgmgrspMgmgMpgmgMpdMpgmgpMdpMpgmgMpMpdgmgMpn'sndp.nsgmpn'sMgmgpdpMgmg'sndpmgrspmgrsMpgmgndpMpgmgMpdMpgmgpMgmgmgrs
Bihagda	bihagda	gmnsgmpmpgrsgmNdpgmggmpn's'snpdNdpgmgmpmpgrssgmpn's'sndppdNdpgmgpmgrssgmpn'ssgmpdn'sgrsndpgmNdpgmggmpdNdpgmgpmgrspn's'snpNdpgmgs.n.nss.n.d.p.p.ns.nsggmgrssggmpmpgrssgmddpgmpmpgrsgmpdNdpgmggmpn'sndpdn'snpdNdppdgmgpmgrsgmNdpgmp'sn's'g'r's's'r'sndpNdpgmggmpmpgrs
Bilaskhani Todi (or Vilakshani Todi)	bilaskhani todi	sGpDDpGssR.N.DssRGRGppDNDDmGRGRssRGpD's's'RNDppDNDmGRRGRssRGppDppDNDmGRRGRs'RNs'R'GR.NsR's'RNDD's'R'G'RNDGpDmGRGR.N.DssRGpDmGRGRGRsR.N.DssRGpDNDpGpD's's'RNDD's'R'RN's'R'G'G'RNDpDNDmGRGRs
Chandrakauns	chandrakauns	smn'snmsGmGs.n.nsGmDn'snD'snDmGmGs.nssGmDn's'snDmGmGs.ns.n.D.nsGmDn'smDmnn's'g'sn'snnDmDnDmmGmGsmGs.nsGmGs.n.ns
Charukeshi	charukeshi	srgmpDN's'sNDpmgrs.D.NsrgmpD.D.NsrgmgrrgmDprgmrsgmDppDNDmgrsrgmgmDpN's'r'sDDN'r'srgmrsmgrgrs.N.DssrgmrgmrsgmDpmgrgmpDN'sgmDNN'sN's'r'sDDN'r'sN'sNDppDNDmgrgmrs.N.D.NrsmpDN's'r's'r'g'r'g'rND's'sNDpDmgrgmDpgmrs.N.D.Nrs
Chhayanut	chayanat	rgp'spr.prrrgmpgmrs'sprgmgmrsrssrgrgpmgrssrgmpdn's'sndpMpdprgmpmgrsrgrsdndprgrsrrggmpmgmrrgmppdprrgmpmgmrs.p.ps.prsrgmpdprrrgggmpmgmrs.psrrsrgmppdppMdpprgmp's'r'sddpdpMprrgrgmpdpMpMpdpdndprgrs.psrrsrgmNdprrsdMppdMpMpdprgmppdpp'srgmNdppr.pr
Darbari Kanada	darbari kanada	.Nsrrs.Nsrsssrrs.Ns.N.D.N.D.Ns.N.Ns.N.NrrGrGGmpmGmrsr.Ns.N.D.N.D.N.Ns.D.NrsmpDpDNDN's'sNDNpmpNNpmpmpmGGmrssrp'sprsrGrGmpDpDNpNmp's'sNDNpmpmGmrs.D.NssrGmpDN's'sDNpmpGmrs'sNDNp
Des	desh	rpn's'sprdsmgrg.nssrmpn's'rNdpsrmpn's'sNdpdmgrg.nsdsmgrg.nssrrmgrsdpNdps'r'r'm'g'rs'gns'ssdsmspnnn'srmpn'srmp'smp'sspn's'rn'sn'sppmgrg.nssdsmgrg.ns
Deshkar	deshkar	pd's'sdpsrgpddgp'sdpdgpgrs.dssrgpd's'sdpdgpgrs'sddppdgpssrgpddgppdgp'sdd's'rd'r's'sddppdgpgrss.dssgpdpgrs
Desi	desi	srpprsrmpdmp's'spdmprGsr.NssrmpN's'spdmprGsr.Nsrmpdmp's'sdpmGrs'spdmprGsr.Nssr.Ns.NsrmpmpdmprGsr.NsrmpGrmpdpdmp'smpN's'spdmpmpDmpGrrmGrGrsr.Ns
Dev-Gandhar (Dwi-Gandhar)	devgandhar	gmp'spr.D.NsrgmgmDmpNDpDmpGrsrgmpGrsDmpGrgmGrssrgmpmGrgmpDN's'sNDpmpGrgmGrssr.NsrgmGrgmmmpDmpGRgmNDppDDpmpGrgmGrsr.NsrgMrgmpmmpDDNN's'rNDpDpGrrgmGrrsmp's's'r'g'm'm'G'r's'rNNDpDpmGrgmmGrgmGrs
Devgiri Bilawal	devgiri bilawal	sgppg'ss.d.n.dsrggrs.d.pg.nrgmggpmgrssrgpdn's'sndpdNdpmgrs.ns.d.pgrsgrs.d.pgs.n.ds.nrggrsgrggmgrs.d.pgrss.nrgmggrgppdn's'sndpdNdpmgrgrs.nrgrs
Devshree	devshree	rpNNprrMpMpNpMrs.N.p.NssrMpN's'sNpMrssrMrs.NsrsrMpMpNpMpNMprMpMpNN'sN's'r's'rN'sNpMpMrsr.Ns.p.Ns
Dhanashree (Bhairavi Ang)	dhanashree (bhairavi ang)	sp'spGsGmpNDppDmpGmGRsGmpGRs.NsGmpN's'sNDpmpGmGRs.NsGmpN's'sNDpmpGmGRs'sNdpmpGmGrspG.NsGRs.NsGmppDmpGGmpGmGRs.NsGmpGmpNDppGmpN'sN's'RN'sNDppDmpGGmpGRspGmpN'spN's'G'R's'G'R'sN'sNDppDNDNDmpGmGmpGmGRs
Dhani	dhani	GN.NsGsGmpGNpGssGmpN's'sNpmGss.N.p.NsGGsG.NssGmGsGmpGGmNpGmGmpGmGsGmp'sN'sN's'G's'GN'sp'spNpNpGmGGmpGsG.NsGs
Durga	durga	srpd'sdmrmpdmr.dsrrpsrmpd's'sdpdmrs.dsrrmr.d.dsrmpdpdmmpddmdmpd'sdd's'sddmmpdmr.ds
Gaud Sarang	gaud sarang	sgrmgprsmgpdp's'sdpmggrmgprssgrmgdpnd's.nsgrmgpMdMp's'sndpMpdpgrmgprs'sndpMpmGmGrmgprsgrmgprs'sndpMpdpMpMpgmrgrmgpMdpMpdpMpgmrgrmgprsMpdn's.nsgmpn'sgrmgprs'sndpmgrs'sdpmgmrssgrmgprsgrmgpndndpmggmpn's'sdpmgMpMpgrmgpdpp's'r's's'sndpmgrgrmgprs
Gaud-Malhar	gaud malhar	srgmrgmgmgrgrsmpdNpmpdn'ssrgmrpmpdn's'sNdNpmgrgrsrgmsrgmmgmgrgrsrgmpmsrgmmmrmrmrpmpdNpgpmmpd'smpdn'sppndn's'sdNp'sdpm'sdpmdNpmmpdNpmgrgrssrgmmrmrmrpmpdNpmpdn's'r'sdNpdpmgpmppndn's'sdpmmrmrpgpmsrgmgrgmgrgrs
Gauri (Bhairav Ang)	gauri (bhairav ang)	sRs.nsgRmgRsR.nssR.nssRgmpDppDn's'snDpmgRgmgRsR.ns.D.n.Ds.nssRgmgRgRmgRsR.nsgmpDppDn'sDnD'snDpmpmDpmgRsR.nsgmpDpmpmDpmgmgmppmgRgRgRmgRs.nsRgmg
Gopika-Basant	gopika basant	.D.NsGmpNDmpGmGsGmDNDpDmpGmGs.D.NssGmpmGGmDN's'sNDmpGmpmGs.D.NsGmGs
Gorakh Kalyan	gorakh kalyan	srmrmrs.N.NdsrmdNd's'sNdmrmrs.N.N.drssrmd's'sNdmrs.N.N.drs.d.Nrs.Nsrsdmdpmmpmsrmrs.N.d.N.d.ds.dsrrrmmrmmdNNdmdmr.N.dssrmrmd's's'r'r'sNdmrpmr.N.dssr.N.ds.NsrmrrmdmmdNdmd'sN's'r'sdNdmmpmrs.Nr.N.ds
Gunkali	gunkali	sRmpDpDmRRs.DsmpDD'sDpDmpmRssRmpD's'sDpmRRs.Ds.D.DsRRsRmmmpmppDmpmRRs.D.DsmpD's's'R'sDp'R'sDpDmpDmRs
Gurjari Todi (Gujari Todi)	gurjari todi	sR.n.DsRGMDMDnDnDMGRGRssRGMDn's'snDMDMGRGRs.D.nss.n.D.M.D.M.n.D.n.nssRsRGGR.n.D.D.n.nssRGMDMDMDn'sDn'sDn's'R'G'RnDMDn's'RD'sD's'RnDMDnDMGMDMGRs
Hameer	hameer	pgmnddpgmpgmrssgmdnd'ssgmndpgmdn's'sndpMpdpgmpgmrs'sndpgmrsgMndddpgmndddpMpgmdgmndn'spdpp'sgmdnd'sMpdn'sMpgmrspgmrsrgmdpgmrssrrspgmpgmrsgmnddpgmdn'spdpp'sgmdnd'sMpdn's's'r'sn'sddp'sndpMpgmrpgmrs
Hansdhwani	hansdhwani	.nrgpgrgpn's'snpgrgpgrssrgpn's'snpgrs.n.p.nrsnp'snpnpggpgrsnd'snpdpggprgrs.nrgsgpgrpgnpgrgrgrs.n.p.nr.n.ps
Hanskinkini	hanskinkini	gmdpmpGrs.nsgmppmpmNdpdpmpgmdpGrs.nsgmpn's'sNdpmpgmpGrs.nsmpNdp'sNdpmpgr'smpGrspG.nspGrs.nsgmpGrsr.nsgmpNdpgmpGrs
Harikauns	harikauns	s.d.NsGMGsGMdN's'sNdMGsGMGs.Ns.d.NGssGMdN's'sNdMGss.N.d.Ns.d.NsGsG.NsGMGMdNdMGsGMdN's's'G'sNdNdMdMGMGs
Hemant	hemant	gmdndmpmndpmgmgrsgmdpmgrssgmdn's'sndpmgrsgrsdpmmpmsgmdpmgrs.n.d.m.d.nsmpmgmdnmdn's's'r'sndn'sdpmmpmmgmgrs
Hemshri	hemshri	.nsGmpmGsG.nsGmp'sNpmpmGmpGpmGsG.ns.nsGmpn's'sNpmGmGs.n.nssGmpmGmpNpnn'sn's'Gn'spn'sNpNpmGmGmpmGs.n.ns.p.nsG.ns
Hindol	hindol	ddnMd'sdMgs.d.dssgMdnMd's'sndMgMgs.dssgMdgMgMggs.d.ds.n.M.dssgMdgMgMd'snMdgMMgs.d.ds
Jaijaivanti	jaijaiwanti	srpn'spr.d.NrrGrs.nsrmpnNdps.d.NrrGrsgmpmgrrmpn's'sNdpmgrGrs.ns.d.Nrsrrgrrgmpmgmgr.prgpdNgNNdpdgrrmpnn'sn's'rNdpdmgmgr.nsrgrrGrs
Jaldhar Kedar	jaldhar kedar	mssrsmmrpmmpd's'r'sdpmpmrssrmpd's'sdpmrssrsmmrpmdpmsdpdpmmrpmsmrpdpmpmrsmrpmr.dsmrpmrssrsmmr.dsmrrpsrssrssmmrrpmpdpmmrpmrss.d.p.m.p.dsrmsrsrppmmpd's's'r's'r'sdpmmpmrs
Jaunpuri	jaunpuri	rmpDmp's'rNDpmpNDpDmpGrmpsrmpDN's'sNDpmGrsrrmmpDmpGrsr.NsDmpGrss.N.NsrrsrrmmppppDDpDpDmprrmmpmpNDpmpDN'srmpDmp's's'r'r's'r'rNN'srNsrNDpDmpGrsrmpDmp's
Jayat	jayat	pdp's'sppdgppgRssRgpdp's'spdppdgppgRspdp's'spdgppd's'sdpsggpp'spdgsgppdppdgpgR'ssRssRgpgRssgppdppdgppgRsRgpgpgRssgppdgppdp's's'R's'sppdppdgppgRs
Jhinjhoti	jhinjhoti	spd'spg.dsrmgrgsr.N.d.p.ds.p.dsrgmgmgrsr.N.dssrmpd's'sNdpmgrgs.p.dsrgmg'spdmgrpmgmgmgrs.N.d.p.ds.p.dsrmgmgsr.N.d.p.dsrmpdNdpdmgrgsr.N.dsrmpdNdpd'ss'rNdpdpmgmgrgs
Jog	jog	gmppmggmpNppNpmgmgmGssgmpN's'sNpmGs.NspmgmgGssmGsmsGsgmp'sN'ssgmpNpmggmmpmpmgmgGsgmpN'sp'sN'sN'sN'sG's'G'sNpmmpgmgmsGs
Jogeshwari	jogeshwari	sgmddmgssgmGs.N.d.m.d.NssgmNdmdN's'sdNmdgmGssgmdN's'sNdmgmGssgmgmsGsGs.N.NssgsGsgmdmmdgmdN's'sNdNdm.d.N.d.Ns.NGssggmmgmGsgmmddmdgmmdN's's'G'sNd'sNdmNdmgdmgmGs
Jogiya	jogiya	smpD'sDmRRmmmpDpDnDppDmRssRmpD's'snDpmmRssRs.DssRmmppmRsRs.DsRmpmpD's'snDpmpDNDmmRs.Ds'snDpmpDNDmmRsrmDm
Jogkauns	jogkauns	smmsgmgmpmgmDn's'snDpDNDmpmgmsGssgmDn's'snDpmpDNDpmgmsGssgmpmgmgGsgmGsmDn's's'G'snDpDNDpmpDNDpmDNDpmNDpmpDNDpmsgmsGssgmpmgmnDDn's's'G'snDpDNDpmmpmgmGsmDn's'G'snDDNDpmgmpmgmsGs
Kafi	kafi	GrmpmpdpdN'sNdpsrmpdmpGrsrGmpdN's'sNdpmGrsdpmpmpGrrGmprGrNdpmGrNdmpdNpd's'sNdpMpdpGrpmGrmGrs
Kalawati	kalavati	gddgsgpdpdNddpgpdsNdNsNpdgpgsNdssgpdN's'sNdpgpgs.N.dssgpdgpdpdp'sNddNdpgpdgdpgpgs.N.ds
Kamod	kamod	smrrpgmpgmrs's'r'sddpmrpdMpgmrssrpgmrsmrpdn's'sndpMpdpgmpgmrsgmpgmrsgmpgmrsMpdpgmdpsmrprrpgmpgmrsMpdpgmddpgmpgmrspdp's's'r's's'r's'sddpMpdMpgmpgmrs
Kaushik Dhwani (Bhinn-Shadj)	kaushik dhwani	gmdnd'sn'sdgmdmgssgmdn's'sndmgs'sd'snds.d.nsgmgmdgmgsgmndmdn's's'g's'g'snddn'sdmmdgmgs
Kausi-Kanada (Kaushi Kanada)	kausi kanada	GmDpmGrGmsGmpmGrGs.D.Nrs.NsGmDN's'sNDpmGrGmrsGmrsGmGssrGmrsrGms.N.Ns.D.N.N.D.Nsrrs.Nsrs.D.D.NsGsGmmpmGmrsGmpmGmNDpmmDN'sNDNDpmGmmpGGmrs'sNDNDppmpmGmpGpmGmGs.D.Nrs
Kedar	kedar	smmpMpdpmsrsMpdpMp's's'r's'sddpsMpdn's'sndpMpdpmmrsNmgpmmpmp's'sdp'sr'r'sddp'sndpMpdpmMpdpMpdNdpMpmMpdn's'r'snsddpdpMpmsrs
Keerwani	keerwani	pD's'sn's'r'G'r'snDpDpmppmGrGmGrs.n.D.nrssrGmpDn's'snDpmGrssrGmDpDpmGrGmppDn'snDppDn'spD's'r's'r'G'r'snDppDn'rnDnDmDmGrGpmGrs.nGrs.n.D.nrs
Khamaj	khamaj	gmpdgmgp'sn'sNdpmpmgrssgmpdn's'sNdpmgrgs.nsgmp.nsgmppdmpmggmpdn'sn'sppdp's'sNdpdpmpdpmgmpmgrgssgmpgmpdpNdppdpNdpmgmpgmgrgs's'r's'sNdpmpmmgrgs.N.ds
Khambavati	khambavati	srmgmsrmpdNNdpdpmpd'spd's'r'g's'rNd'sdmpgmsr.N.dssrmpd's'sNdpdmpgmsr.N.dsgmssrmpd'sgms'smpnn's'sNdpmgms'sNdpdmpgms'sdNpdmpgms'sNdpmgs'sNdpmgrgsrrmmpmpdNNdmpd'sd's'rNNdpdmpmgmssr.N.N.d.dsrmgsdmpgmsr.N.dsgrgs
Komal Rishabh Asawari	komal rishabh asavari	smpDDmRmpD's'RNDmGRGRssRmpD's's'RNDmpDmGRGR.N.DRssRGGRGRs's'RNDD's'R'G'RNDsRmppDppDNDmGRRGRssR.N.D.p.D.N.D.m.p.D.DsRRGRGR.N.DsRmmpmpDmpDNDmmGRGR.N.DsmpD's's'R'R's's'R'G'R'G'RNDDmpmpD'spDNDmpDmGRGR.N.Ds's'RNDpDmpmpNDpDmpmGRs
Lalit	lalit	.nRgmMmgRsgMDnDMm'RnDMmgmMmgMgRs.nRgMDn's'snDMDMmgMgRsmMm.nRgmMmgMDnDMmMDn'sMDM's's'RnDMDnMnDMDMmgmMmgMgRsDMD's'sn'RnDMmgRs
Lanka Dahan Sarang	lanka dahan sarang	mp'sNpmprGrs.N.p.m.p.nssrmpn's'sNdpmpdpGrGrs.nsdprGrsrGrsdNps.ns.nsrsrs.N.p.m.p.N.ps.nsr.nsrrpmmprmpdpmpmNp'sdNpmpGrGrs.N.p.m.p.nsrrmmpNpmp'sNpmpGrGrs.nsrGrsr.nssrmprGrsrmGrrdppdpNdprGrs.N.d.prs
Madhukauns	madhukauns	sGMpMGMpMpN's'sNpMGMGssGMpN's'sNpMGssGMpsGsGMGssGMpMpGMGGMpNpNMppMGMGsGMpN'sN'G's'GN's'sNpMpMGMpNpNMpGMGMGs
Madhumad Sarang	madhumad sarang	.NsrmrpmrNpmrpmrs.NsrmpN's'sNpmrs.NsrmprmrNpmrmrsr.NsrmpNpmr.NsrsmpN's'sNpmpprmrNpmrs
Madhuvanti	madhuvanti	.nsMGMpMGsrs.nsGMpn's'sndpMGMGrs.nsMGsrs.nsMMGrsndppdpMGMGrsGMpn'sn'sddpdpMGMGMGrsr.ns
Malgunji	malgunji	gmGrs.Ns.d.NsrgmsrgmdN's'sNdpmgrgmGrss.d.nsrgmmdnss.d.NsrgmmdN's'sNdpmgmmGrss.N.d.Nsrgmmdn's's'r's'rN's'r'r'sNdpNNdpmgrgmmGrs
Malhar (Miya Malhar)	miyan malhar	srrpGGmrs.Nd.n.ns.nsmrpGmrsmrpNdn's'sNdNpmpGGmrs.ns.N.d.n.m.p.N.d.n.ns.nrrsr.d.N.p.N.dns
Malkauns	malkauns	sGmDN's'sNDmGsGGm.D.NsmGmGGmGsmmDDNNDmGGmGs.N.NsGsGmDmmDNDmGmDNmDNN'sNN's'G'm'G'sN'sDNDmGmGNNDDmGGmGs
Mand	mand	gmpd'snddpmmpgrgssrgmpdnpd's'sndpmgrgsgmppd'snddDdpmmpmmgGgdDd's'sndpgmpsrgssrmmpmpmmgsrgsrs.n.d.d.p.n.d.p.m.p.d.n.p.dssrmmpgmpdnpndmgmpdnpd's's'r's'r's'snddn'sndpdmpgsrgs
Maru Bihag	maru bihag	MgMgrss.nsmgpMgMgrssgMpn's'sndpMgMgrsMgrs.nsgMgrsgMpnn's'sndpn'sdpMgMgrssmmgpdpMgMgrs
Marwa	marwa	s.n.ds.nRRgMddMgR.n.dRss.d.nRgMdn's'sndMgRs.n.ds.nRss.n.d.nRgMdMgR.n.dRsMdMd's'sdn'RndMdMgRgR.n.dRs
Megh Malhar (or Megh)	megh malhar	.NsrpmrmpmrmppmNpmrrrpmrrs.Nssmrmp.N's'sNpmrsr.NssrmrmpNpmrNpNppNps.N.N.N.p.p.Ns.p.N.ps.p.Nsmr.Nsmrmrmrpmrmmmrmrs.Np.Ns.NsmrmpNpmp'spN'spNp'spN's'r'r'r's's'r's's'r'sNpmpNpmrs.NsmrpmrrmpNNpNNpmrrpmNpN'sNpmr.Nrs
Mohankauns (different flavor)	mohankauns	sgmGs.N.D.NssmgmDNDmgmgGssgmDN's'sNDmGss.N.D.D.NssggmgmGsgmDmDN's's'G'sNDmgmNDmgmDgmGssgmDN's'sNDmgmrgmgssgmmgrgmgssgmmrgms
Multani	multani	.nsMGMGpMGMGRs.nsGMpn's'snDpMGRs.nsMGMGsRspMpMGpGMGppDMps.nsMGMGsRs.nsMGMpMpMGMGsRsGMpMpGMGpMDppMGGMpnnDpGMpn's's'G's'Rn'sn'snDppDMpGMGMGsRs
Nand (Anandi)	nand	sgmdprsgmpdndppdpmmpgmdprssgmdprsgmpn'ssdnpdMpggmdprssgmdprssgmpn's'sndpgmpdnpdMpgmdprs'sdnpdmpggmdprsgmgmdpMpdMpggMpgMrsgmdprsssgmdprsgmpdndppdpmmpgmdprsgmpnspn'rndppdMpgmdprsgmpdnppdpMdpgmdprs
Narayani	narayani	sr.N.d.p.m.p.dsmrmrssrpmpNddpdpmrssrmpd's'sNdpmrssrpmpNddpsrpmpmpdNd'smpd's'srNd's's'r'm'r's'sNddpmpdpmrmr.N.ds
Nayaki Kanada	nayaki kanada	r.NsrpmGGmpmrsrsGmNpNmpmGmpmrsrrsmpNp'spNpGmrssrmGmpNp's'sNpNpmpmGGmrsr.NsrpmGmsrGmmNpmpNp's'sNpNpmpGmpmrsrsrpmNpGmpmrsrssr.NsrpGmGmpmrsrssrrGmmNpmpNpmp'smpN's'sNpNpNNpmpNNpmpGmpmrsrs
Nut Bhairav	nat bhairav	rgmDpmgrgmrs.n.DssrgmpDn's'snDpmgrssrrggmmpmgmrsrspDDpDn's'snDppmgmgmDn'sDnD's's'r'sDDp'snDpsrrggmmpmgmrsrgmDppDmmpggmrgrgmrs.n.DsgmDn'snD's's'R's's'R'snDpn's'R'sDpgmrrs.D.ns
Pancham Jogeshwari	pancham jogeshwari	sgmddmgssgmGs.N.d.m.d.NssgmmpmGsNdmdN's'sdNddmpmGssgmdN's'sNdmgmpmGsmpmgmpmGs.d.N.d.Nss.NGssggmmgmGssgmpmmgmdgmmddmdgmmgpmGssgmdNdN's's'G'sNd'sNdmNdmgdmgmpmGs
Parmeshwari	parmeshwari	sRGmdmGmdmGRGR.N.D.D.NRssRGmdN's'sNdmGRssRGmGmdmmdN'sdN'R's'sNdmmGRGR.N.d.d.NRs
Patdeep	patdeep	Gmpn'sdpmGmpnnn'sdpmGmppGmGrs.n.ns.nsGmpn's'sndpmGrs.ns.nsGmpmGsrspGmGmpdpGmpn'sn'sdpdpmGmGmpmGmGsrs
Pilu	pilu	gmpn'sNdpmpnDpmGrspGrs.nsGrssgmpn's'sNdpmGrs.nsGrs.p.nsGGrs.n.nssGrs.n.m.p.nsGrss.n.D.p.p.nsGGmpmGGrs.nssggmGrssgmpNdpgmdpGrs.ns.nsrs.n.d.p.m.p.n.ns
Poorvi	purvi	sRgMgmgMDpnDpgMpMgmgRssRgMpDn's'snDpMgmgRss.n.D.nRs.nsRgRgMppMgmRgRs.nRg.nsRgs.n.D.nRss.nsRgRmggMppMgmgRgMpDMpMgmRggMDn's'snRnDpDMpgmRgRs.nsRgRs
Puriya	puriya	nrggMdgMgnMggMgRs.n.M.ds.nRgRs.nRgMdn's'sndMgMdgMgRsgMdnnMggMdgMgnMdggMdnd's.nRggR.n.d.n.n.M.dsgMdnnMggMdgMgRsgMdnd'sn'RnMggMdgMgRs
Puriya Dhanashri	puriya dhanashri	.nRgMppMgMRgMDpMDn'sn'RnDppDppMgMRgRs.nRs.nRgMpMDn's'snDpMgMRgRs.nRgMppDppDMpMgMDn'sn'RnDpMDMgRgMRgRs.nRgMpMDn'sn'R'g'g'R'sn'RnDpDpMpMgMRgRspMgMRg.nRggMgMpDpDMpMgMRggRMgRs.nRs.nRggMMgRgRgMpMGMRRgRgMpDpDMppDpMgMRg.nRMgRgRs.D.nRgMDn's'sn'R's'RnDppDpMDpDpMgMRgRspDpMgMDn'sn'R'sDn'R'g'g'R'sn'RnDpDpMgMRgRgMpDpMgMRgRs
Puriya Kalyan	puriya kalyan	.nRgMpMRgRsMdpMdn'ssRgMpdn's'sndpMgRgRs'sndpMdndppMGMRgRsMdGMGMGRsMdn's.nRggMMgMdpMdndppMdpMgMRgRsMdMnndMdpdn'sndpgMdn'sndnd'sn'sdn'R'sn'R'g'g'M'g'g'R'sndndppMdpMndMgMpMgpdMpMggRRs.n.d.M.d.nRs
Rageshree	rageshri	.N.d.NsgmrsgmdNdmgmrssgmdN's'sNdmgmrs'sNdmgrs'sNdmgmrsdgmgmdggmNdgmrssgrgmrsgmpmgmrs'sNdmgmpmgmrss.N.d.Nsgmr.NsgmdmdgmgmdN's's'r's'sNdNdgmmgmrsdN'sdN's'r'sNdmgrs.N.d.d.Nsgmrs
Ramdasi Malhar	ramdasi malhar	srgmmrppgmpGGmrs.nsrgmpgmrpmpdn's'sNdNpdpmgmpGGmrspGmrssmrppGGmrssrggmmgmNpGGmrsmrpmpdn's'sNdNpmpdNpdpmgmNpGGmrs
Ramkali	ramkali	MpDNDpMpgmRssRgmpDn's'snDpMpDNDpMpgmRsMpDNDpgmRs.nsgmpsRgmmgmRs.nsgmpMpgmRsgmDn'spDn'ss'R's'R'R'sn'snDpMpDNDpMpDMpgmrs
Saalag Varali	saalag varali	GpdNdpdNd's'sNdpdNdpRGRssRGpdN's'sNdpGRspdNd'sdNd'ss.N.d.d.NssRGRs.NsRGppGpRGGRs.N.d.ds.NR.N.dsRGppddNdpGpdNd'sNdpdNd'spdNd'sN's'R's'sNdpdpGRGpRGRs
Sarang (Brindavani Sarang)	brindavani sarang	rmprmr.nsmpNpmr.nssrmpn's'sNpmrs.ns.nsrrpmprrmsrsrpmnNpmrrmpmrNpmr.nsrrmrs.nssrmpprmrNpmpnn's'sNpNpmrpmr.ns.nsrs
Saraswati	saraswati	rMpdNdpMdpMrMpd'sNdsrMpd's'sNdpMpMrs.N.dsrMpd'sNdMpNdrMp'sNdpMdpMr.N.dsrrMMprMpdNdpd's'rNNdpdpMpMrrMpMNdpMpMrsr.N.dssrMprMpd'sNdMpMrsr.N.ds
Saraswati Kedar	saraswati kedar	rMpdpMpmrsMpdNdpd's'sNdpMmrs.N.dssrMpd's'sNdpMpdpMmrsrrMMpMpdNdp.N.dsMpdn'spdpmmgp's'r's'm'm'rssrMMMppdpNNdpdpMpmsrMpd'sNdpdMpdpmmsrrsMpdp'sMpdn'sdNdpdpMpmsrMpMprMpd'sdNdpd's'r'sNNdppdpmM's'r'sd's'r'sNdpMpmsrrs
Shahana Kanada	shahana kanada	spd'sdprpmGmddNp'sdNpdmpGmrs.NsrGmpmGmdNpmpdN's'sdNpmpGmrsGmddNpNdNpdmp'sdNpGmrsNdNpmNdNpNsrGmmpmGmddNpGmpdN's'sNdNpdmp'sN's'r's'sNdNpmpGGmrs
Shankara	shankara	gpnd'sndpgprgrssgpnd's'snpgpdpgprgrsgpnd'sn.n.n.ns.p.n.ps.p.n.ds.n.ns.p.nsggpgsgpgpdppgpggrs.nsggppnd'snnpgpnn's's'r'snnd'snpgpgrs
Shivranjani	shivranjani	srGpd's'sdpGrsr.dsp's'sprGpdpGrGsrdssrGpdpGrGsr.dsrGpdpd'sd'sdpGrpdpGrGrGsr.ds
Shobhawari	shobhawari	srmpD's'sDpmrs.Dssmp'spmrmpDpmrmpDpmrssrmrmpmpDpDmrmpD'sD's'r'sD'sDpDmDpmpmpDDppDmpmrmrsr.DsrmDpmrs
Shree	shree	s.nRRRpMpDMgRgRsMpn's'R'RnDpMDMgRgRssRMpn's's'RnDpMpDMgRs'RnDpDMGRss.nRMppRRpMpDMgRRpRgRsMpnn'sMpn's'R'R's'RnDppMpDMgRgRpRgRs
Shuddha Kalyan	shuddha kalyan	grgrs.n.d.pgrsgrgprssrgpd's'sndpMgrsgrgprs'sndpMgs.n.d.n.d.p.p.dssgrs.d.pgrgsrs.n.dsgrgprssrgpMgrgpdp'sd's'sndpMgrgrsgrgprs
Shuddha Sarang	shuddha sarang	.nsrMMpMpMmrr.n.ns.n.ds.nrs.nsrMpn's'sndpMpMmrs.nsMmrs.n.ds.nrssrMpnspdnsndpMpn'sMpdn'sMmrs.nsrmrsMpNpMmrs.nsrrmrs.n.d.p.n.ds.nrs.nsrmrMpprmrs.nsrs.nsrmrMprMpndppn's'r's's'r'snd'sndpMpMmrmrs.nsrs
Shyam Kalyan	shyam kalyan	sr.nsmrrMMppgmrMpgmpgmr.nsrs.nsrMpn's'sndpMpdpgmpgmrs.nsgmpgmrsgMpn'srMpn'sgmpgmrs'sndpMpdpgmpgmrsp's's'r'sn'sdps.nsrMpMpdpMpn's's'r'sndpMpdpgmr.nsrspdpp's's'r's's'r'sdpMprMpn'sn'sddp'sndpMpgmpgmrr.ns
Sindhura	sindhura	rmpdNdp's'r'G'r'sNdpmGrmGrssrmpd's'sNdpmGrmGrssrmpd's'smpnn'smpGrmpmGrmGrssrmpdpmpdpmGrmGrsGrmpd's's'r's'sNdpmpdpmGrmGrsmpnn's'G'rNd'smpd's'r'G'r'sNdpmGrmGrs
Sohani	sohani	Mdn's'R'sndnd's'R's'Rn'sndgMgsgMdn's'sndndMgRsdgndgMgdg'sndMdgMggMdn's's'R's'Rn'sndndgMgMdn's'R'ss.nsggMdndgMggMdn's'sn'R's'Rns's'R's'Rn'sndndndgMggMdgMgRssgMdn's
Suha Sughrai	suha sughrai	pNmp'sNNpmrsrmGGmrssGmrssmmpGmrsmpNppNmp's'spNpmpGmrssrmpmrpGmrsmpNp'sN's'r'sN'spNpNNpmrsrmGGmrss.Ns.p.N.ps.NsrrmGmGmrssrmppGmrpmpGmrs.NsrmpmpNpNmpGmrsrGmpmNsppNmp'ssrmpN'spN's'r's'r'spNpmpGmrpmpN'sNNpmrsrmGGmrs
Sundarkali	sundarkali	sRgpNpgpNpgRsRs.NsRssRgpN's'sNpgpgRssRgppgpgRsgpNppN's's'R'sNpgpgpNpgRs.NsRs
Sundarkauns	sundarkauns	.N.N.d.d.NsGmGsGmdNdmdN's'sdNdmGssGmdN's'sNdmGmGs.NssGmdN's'sNdmGs'sNdmpdmGrss.N.N.d.NsGmGs.NsGmddNdmGmGsGs.Ns.d.N.d.m.d.NsGmGsGmNdmdN'smd'sNNdNdmdGmGmGs
Surdasi Malhar (Sur Malhar)	surdasi malhar	mr.ns'sNdmpNdpmrpmdpmr.nssrmpn's'sNdpmdpNdpmr.nssrmpn'smrpmpNn's'sNdpmrpmdpNdpmr.ns'smr.ns'sNdmpNdpmrmrmrpmdpmrsrmpNdpmpNn's'sNdpmdpNdpmr.ns
Tilak Kamod	tilak kamod	.p.nsrgs.nsrpmgsrgs.nrppmgsrgs.npmgsrgrs
Tilang	tilang	gmpNpmgNpgmgsgmpn's'sNpmgs.ns.p.N.p.p.N.ps.ns.p.nsggmpNmpnn'spn'spn's'g'r'spn's'g'g'm'm'p'g'r'sn's'rsNpmpmgmgs.ns
Tilang Bahar	tilang bahar	mpmGmNpmpn'sGmpmGmrssrsmgmpNpmdn's'sNpmGmrsgmgmpmgmrsmdn'sdn's'r's's.Npmgmpmdn'sNpgmrs
Todi	todi	.D.nsRGMRGRssRGMpDn's'snDpMGRssRGRGGRGRssRGMppMDpMDnnDpMDMGRGRsMDn'ssRRsRRGRs.D.D.n.nsRRGRssRGMppMDpMDnMDn's's'R'G'R'G'R's'snDnDpMDnDMGRs
Vachaspati	vachaspati	.NsgMpdpMgrsr.NsMgrssgMpN's'sNdpMgrs.Ns
Vibhas	bibhas	pDDpgpgRssRgpD's'sDpgRspDpgpsgpgp'sDpgppDpgpD'sDpDpgpgpDpgpgRs
Yaman	yaman	.nrg.nrMgMpMdpndpMrgr.nr.d.ns.nrsnrgMpdn's'sndpMgrs.nrs.nr.nrg.nr.ngrg.nMgrs.nrgMrgMpMdpMdnMdMngMgndpMrg.nrs.d.n.ds.d.nrg.nrggrg.nr.ng.nrgMrMggrMgMpgMprs.nrs.nrgMpMpMppMdpMpMdMnndpMggMdnMdnndpMgrs.nrs